2000000000000000000000000000000000000000000000000000000000000000
1200x00000000000000000000000000000000000000000000000000000000000
1122222222222220000000000022222222222000000000000000000000000000
1111111111111110000000000010000000000000000000000000000000000000
1111111111111112000000000010000000000000000000000000000000000000
11111111111111110000x00x0010000000000000000000000000000000000000
0000000011111111222223322210000000000000000000000000000000000000
0000000000000000000000000000000000000000000000000000000000000000
0000000000000000000000000000000000000000000000000000000000000000
0000000000000000000000000000000000000000000000000000000000000000
0000000000000000002222222200000000000000000000000000000000000000
0000002222220000000000000000000000000000000000000000000000000000
0000001111110000000000000000000000000000000000000000000000000000
0000001111110000000000000000000000000000000000000000000000000000
0000001111122222222222000000000000000000000000000000000000000000
2000000000000000000000000000000000000000000000000000000000000000
0200000000000000000000000000000000000000000000000000000000000000
0022000000000000000000000000000000000000000000000000000000000000
0000220000000000000000000000000000000000000000000000000000000000
0000002220000000000000000000000000000000000000000000000000000000
0000000002220000000000000000000000000000000000000000000000000000
0000000000002222000000000000000000000000000000000000000000000000
0000000000000000222222222222222222222222222222222222222222222222
0000000000000000000000000000000000000000000000000000000000000000
0000000000000000000000000000000000000000000000000000000000000000
0000000000000000000000000000000000000000000000000000000000000000
0000000000000000000000000000000000000000000000000000000000000000
0000000000000000000000000000000000000000000000000000000000000000
0000000000000000000000000000000000000000000000000000000000000000
0000000000000000000000000000000000000000000000000000000000000000
0000000000000000000000000000000000000000000000000000000000000000
0000000000000000000000000000000000000000000000000000000000000000
