2200000000000000000000000000000000001100000000000000000000000002
1100000000000000000000000000000000001100000000000000000000000001
1100000000000000000000000002222000001100000000000000000000000001
1100000022222220000000000021111200x01100000000000000000000000001
1122222211111112000000000011111122221100000000000000000000000001
11111111111111110000x00x0011111111111100000000000000000000000001
1000000011111111222223322211100000000000000000000000000000000001
1000000000000000001000000110000000000000000000000000000000000001
1000000000000000003000000110000000000000000000000000000000000001
10000000000000000030x0000110000000000000000000000000000000000001
1000000000000000002222222110000000000000000000000000000000000001
1000002222220000021111111100000000000000000000000000000000000001
1000001111110000000001100000000000000000000000000000000000000001
1000001111110000000001100000000000000000000000000000000000000001
1000000111112222222221100000000000000000000000000000000000000001
1000000000011111110000000000000000000000000000000000000000000001
1200000000000000000000000000000000000000000000000000000000000001
1122000000000000000002222200000000000000000000000000000000000001
1111220000000000000020000000000000000000000000000000000000000001
1001112220000000000010000000000000000000000000000000000000000001
1000011112220000000200000000000000000000000000000000000000000001
1000000011112222000100000000000000000000000000000000000000000001
1000000000011111222122222222222222222222222222222222222222222221
1000000000000001111111111111111111111111111111111111111111111111
1000000000000000000000000000000000000000000000000000000000000001
1000000000000000000000000000000000000000000000000000000000000001
1000000000000000000000000000000000000000000000000000000000000001
1000000000000000000000000000000000000000000000000000000000000001
1000000000000000000000000000000000000000000000000000000000000001
1000000000000000000000000000000000000000000000000000000000000001
1000000000000000000000000000000000000000000000000000000000000001
1222222222222222222222222222222222222222222222222222222222222221
